################
#GGGGG @ VVVVV #
#   X      GGG #
#              #
#              #
#   d    d     #
#          d   #
#  d           #
#              #
#              #
#       d      #
#  d        d  #
#              #
#       d      #
#d            d#
################
